    wwwwwwww
    w      w
    w I    w
    w      w
wwwww    G w
w          w
w F   f    w
w          w
wwwwwwwwwwww
    w      w
 B  w W    w
 I  w I  b w
 Y  w S    w
    w      w
    wwwwwwww
